"""
This file was created automatically.
For more instructions read the README.md
"""
key_and_lock: False
icy_floor: True
occlusion: False

maze:
-----------------------------------------
|                       |             E |
|   + - + - + - + - +   +   +   + - + - |
|       |               |   |           |
| - +   +   + - + - + - + - + - +   +   |
|       |                       |   |   |
|   +   +   + - + - + - + - +   + - +   |
|   |   |               |   |           |
|   + - +   + - + - +   +   + - + - +   |
|   |         I |       |               |
|   +   + - +   +   + - +   + - + - + - |
|       |           |       |           |
|   + - +   + - + - +   + - + - +   +   |
|   | I             |       |       |   |
| - +   + - +   +   + - +   +   + - +   |
| I   I |   |   |       |   |   |   |   |
|   + - +   +   +   + - +   +   +   +   |
| I |           |       |       |       |
|   +   + - + - + - +   + - + - +   + - |
| S                 |                   |
-----------------------------------------
end