"""
This file was created automatically.
For more instructions read the README.md
"""
key_and_lock: True
icy_floor: False
occlusion: False

maze:
-----------------------------------------
|       |               |         D   E |
|   +   +   +   + - + - +   + - +   + - |
|   |       |                   |       |
|   + - + - + - + - + - + - + - +   +   |
|   |                       |       |   |
|   + - + - +   + - + - + - +   + - +   |
|       |       |               |   |   |
| - +   +   + - +   + - + - + - +   +   |
|       |       |           |       |   |
|   + - + - +   + - + - +   +   + - +   |
|               |           |           |
| - + - + - + - +   + - + - +   + - + - |
|               |           |           |
|   + - + - +   + - + - +   + - + - +   |
|   |       |           |       |   |   |
|   +   + - + - + - +   + - +   +   +   |
|   | K             |           |   |   |
|   +   + - + - +   + - + - + - +   +   |
| S |           |                       |
-----------------------------------------
end