"""
This file was created automatically.
For more instructions read the README.md
"""
key_and_lock: False
icy_floor: False
occlusion: True

maze:
-----------------------------------------
|   |               |   |           | E |
|   +   + - +   +   +   +   +   +   +   |
|       |       |   |           |   |   |
| - + - +   + - +   + - + - +   +   +   |
|           |   |               |   |   |
|   + - + - +   + - + - + - + - +   +   |
|       |                       |       |
|   +   +   +   + - +   +   + - + - +   |
|   |   |   |   |           |       |   |
| - +   +   +   +   + - +   +   +   +   |
|       |   |   |       |       |       |
|   + - +   +   + - +   + - +   + - + - |
|   |       |       |   |               |
|   + - +   + - +   +   + - + - +   +   |
|       |       |       |       |       |
|   +   + - +   + - + - +   +   + - +   |
|   |       |   |           |       |   |
| - +   +   +   +   +   + - + - +   +   |
| S     |           |                   |
-----------------------------------------
end